\rm	Font
\sl	Font
\it	Font
\bf	Font
\tt	Font
\oldstyle	MFont
\mit	MFont
\cal	MFont
\itfam	Font
\slfam	Font
\bffam	Font
\ttfam	Font
\magstephalf	Mag(1.1)
\magstep0	Mag(1.0)
\magstep1	Mag(1.2)
\magstep2	Mag(1.4)
\magstep3	Mag(1.7)
\magstep4	Mag(2.1)
\magstep5	Mag(2.5)
\magstep6	Mag-
\`	Accent(ò)
\'	Accent(ó)
\v	Accent(ǒ)
\u	Accent(ŏ)
\=	Accent(ō)
\^	Accent(ô)
\.	Accent(ė)
\H	Accent(ő)
\~	Accent(õ)
\"	Accent(ö)
\t	Accent
\c	Accent(ç)
\d	Accent
\b	Accent
\oe	Char(œ)
\OE	Char(Œ)
\ae	Char(æ)
\AE	Char(Æ)
\aa	Char(å)
\AA	Char(Å)
\o	Char(ø)
\O	Char(Ø)
\l	Char(ł)
\L	Char(Ł)
\ss	Char(ß)
\dag	Char(†)
\ddag	Char(‡)
\S	Char(§)
\P	Char(¶)
\Orb	Char(〇)
\%	Char(%)
\&	Char(&)
\#	Char(#)
\$	Char($)
\_	Char(_)
\copyright	Char(©)
\braceld	MChar
\bracerd	MChar
\bracelu	MChar
\braceru	MChar
\alpha	MChar
\beta	MChar
\gamma	MChar
\delta	MChar
\epsilon	MChar
\zeta	MChar
\eta	MChar
\theta	MChar
\iota	MChar
\kappa	MChar
\lambda	MChar
\mu	MChar
\nu	MChar
\xi	MChar
\pi	MChar
\rho	MChar
\sigma	MChar
\tau	MChar
\upsilon	MChar
\phi	MChar
\chi	MChar
\psi	MChar
\omega	MChar
\varepsilon	MChar
\vartheta	MChar
\varpi	MChar
\varrho	MChar
\varsigma	MChar
\varphi	MChar
\Gamma	MChar
\Delta	MChar
\Theta	MChar
\Lambda	MChar
\Xi	MChar
\Pi	MChar
\Sigma	MChar
\Upsilon	MChar
\Phi	MChar
\Psi	MChar
\Omega	MChar
\aleph	MChar(א)
\imath	MChar
\jmath	MChar
\ell	MChar
\wp	MChar
\Re	MChar
\Im	MChar
\partial	MChar(∂)
\infty	MChar(∞)
\prime	MChar(')
\emptyset	MChar
\nabla	MChar(∇)
\top	MChar(⊤)
\bot	MChar(⊥)
\triangle	MChar(△)
\forall	MChar(∀)
\exists	MChar
\neg	MChar(¬)
\lnot	MChar(¬)
\flat	MChar(♭)
\natural	MChar(♮)
\sharp	MChar(♯)
\clubsuit	MChar(♠)
\diamondsuit	MChar(♢)
\heartsuit	MChar(♡)
\spadesuit	MChar(♣)
\coprod	MChar
\bigvee	MChar
\bigwedge	MChar
\biguplus	MChar
\bigcap	MChar
\bigcup	MChar
\intop	MChar
\int	MChar(∫)
\prod	MChar(∏)
\sum	MChar(∑)
\bigotimes	MChar
\bigoplus	MChar
\bigodot	MChar
\ointop	MChar
\oint	MChar(∮)
\bigsqcup	MChar
\smallint	MChar
\triangleleft	MChar
\triangleright	MChar
\bigtriangleup	MChar
\bigtriangledown	MChar
\wedge	MChar(∧)
\land	MChar(∧)
\vee	MChar(∨)
\lor	MChar(∨)
\cap	MChar(∩)
\cup	MChar(∪)
\ddagger	MChar(†)
\dagger	MChar(‡)
\sqcap	MChar
\sqcup	MChar
\uplus	MChar
\amalg	MChar
\diamond	MChar(◇)
\bullet	MChar(・)
\wr	MChar
\div	MChar
\odot	MChar(⊙)
\oslash	MChar
\otimes	MChar
\ominus	MChar
\oplus	MChar
\mp	MChar(∓)
\pm	MChar(±)
\circ	MChar
\bigcirc	MChar
\setminus	MChar
\cdot	MChar
\ast	MChar(*)
\times	MChar(×)
\star	MChar(★)
\propto	MChar
\sqsubseteq	MChar
\sqsupseteq	MChar
\parallel	MChar(||)
\mid	MChar(|)
\dashv	MChar(┤)
\vdash	MChar(├)
\nearrow	MChar
\searrow	MChar
\nwarrow	MChar
\swarrow	MChar
\Leftrightarrow	MChar(<=>)
\Leftarrow	MChar(<=)
\Rightarrow	MChar(=>)
\leq	MChar(≤)
\le	MChar(≤)
\geq	MChar(≥)
\ge	MChar(≥)
\succ	MChar
\prec	MChar
\approx	MChar(≈)
\succeq	MChar
\preceq	MChar
\supset	MChar(⊃)
\subset	MChar(⊂)
\supseteq	MChar(⊇)
\subseteq	MChar(⊆)
\in	MChar(∈)
\ni	MChar(∋)
\owns	MChar(∋)
\gg	MChar(>>)
\ll	MChar(<<)
\not	MChar
\leftrightarrow	MChar(<->)
\leftarrow	MChar(->)
\gets	MChar(<-)
\rightarrow	MChar(<-)
\to	MChar(->)
\mapstochar	MChar
\mapsto	MChar
\sim	MChar(～)
\simeq	MChar
\perp	MChar
\equiv	MChar(≡)
\asymp	MChar
\smile	MChar
\frown	MChar
\leftharpoonup	MChar
\leftharpoondown	MChar
\rightharpoonup	MChar
\rightharpoondown	MChar
\lhook	MChar
\hookrightarrow	MChar
\rhook	MChar
\hookleftarrow	MChar
\ldotp	MChar
\cdotp	MChar
\colon	MChar(:)
\endgraf	\par
\endline	\cr
\bgroup	{
\egroup	}
\repeat	\loop
\+	Align
\sp	^
\sb	_
\|
\}
\{
\headline={stuff}	Insertion
\footline={stuff}	Insertion
\footnote{mark}{text}	Insertion
\topinsert{stuff}\endinsert	Insertion
\midinsert{stuff}\endinsert	Insertion
\pageinsert{stuff}\endinsert	Insertion
\pageno	Count
\allocationnumber	Debug
\maxdimen	Dimen
\hideskip	Glue
\centering	Glue
\smallskipamount	Glue
\medskipamount	Glue
\bigskipamount	Glue
\normalbaselineskip	Glue
\normallineskip	Glue
\normallineskiplimit	Dimen
\jot	Dimen(\openup)
\interdisplaylinepenalty	Count
\interfootnotelinepenalty	Count
\strutbox	Box
\mscount	Count
\tabs	Box
\rootbox	Box
\footins	Insert
\topins	Insert
\wlog	Debug
\newcount	Count
\newdimen	Dimen
\newskip	Glue
\newmuskip	Glue
\newbox	Box
\newhelp\cs{help msg}	Debug
\newtoks	Token
\newread	IO
\newwrite	IO
\newfam	Font
\newlanguage	Debug
\newinsert	Insert
\newif\iffoo	Debug
\frenchspacing	Typeset
\nonfrenchspacing	Typeset
\normalbaselines	Typeset
\lq	`
\rq	'
\lbrack	[
\rbrack	]
\space	Char( )
\empty	{}
\line{stuff}	Insertion
\leftline{stuff}	Insertion
\rightline{stuff}	Insertion
\centerline{stuff}	Insertion
\hidewidth	Align
\ialign	Align
\multispan	Align
\cleartabs	Align
\settabs	Align
\tabalign	Align
\+	Align
\cr	Align
\null	Typeset
\obeyspaces	Typeset
\loop{do \if test}\repeat
\thinspace	Kern
\negthinspace	Kern
\enspace	Kern
\enskip	Kern
\quad	Kern
\qquad	Kern
\smallskip	Glue
\medskip	Glue
\bigskip	Glue
\nointerlineskip	Typeset
\offinterlineskip	Typeset
\topglue	Glue
\vglue{glue}	Glue
\hglue{glue}	Glue
\slash	Char(/)
\break	Typeset
\nobreak	Typeset
\allowbreak	Typeset
\filbreak	Typeset
\goodbreak	Typeset
\eject	Typeset
\supereject	Typeset
\removelastskip	Typeset
\smallbreak	Glue
\medbreak	Glue
\bigbreak	Glue
\rlap{stuff}	Typeset
\llap{stuff}	Typeset
\underbar
\strut	Typeset
\hang	Typeset
\textindent{text}	Insertion
\item{mark}	Insertion
\itemitem{mark}	Insertion
\narrower	Insertion
\beginsection{section title}\par	Insertion
\proclaim {prop}. {text}\par	Insertion
\raggedright	Typeset
\ttraggedright	Typeset
\leavevmode	Debug
\mathhexbox#1#2#3	Debug
\oalign	Char
\ooalign	Char
\dots	Char(...)
\TeX	Char
\hrulefill	Insertion
\dotfill	Insertion
\rightarrowfill	Insertion
\leftarrowfill	Insertion
\downbracefill	Insertion
\upbracefill	Insertion
\bye	Job
\,	\thinmuskip
\>	\medmuskip
\;	\thickmuskip
\!	-\thinmuskip
\*	MChar(*)
\hbar	MChar
\surd	MChar(√)
\angle	MChar(∠)
\neq	MChar(≠)
\ne	MChar(≠)
\joinrel	Typeset
\relbar	MChar
\Relbar	MChar
\bowtie	MChar
\models	MChar(|=)
\Longrightarrow	MChar(=>)
\longrightarrow	MChar(->)
\longleftarrow	MChar(<=)
\Longleftarrow	MChar(<-)
\longmapsto	MChar(|->)
\longleftrightarrow	MChar(<->)
\Longleftrightarrow	MChar(<=>)
\iff	MChar(<=>)
\ldots	MChar
\cdots	MChar
\vdots	MChar
\ddots	MChar
\acute	Accent
\grave	Accent
\ddot	Accent
\tilde	Accent
\bar	Accent
\breve	Accent
\check	Accent
\hat	Accent
\vec	Accent
\dot	Accent
\widetilde	Accent
\widehat	Accent
\overrightarrow
\overleftarrow
\overbrace
\underbrace
\skew#1#2#3	MChar
\lmoustache	Delimiter
\rmoustache	Delimiter
\lgroup	Delimiter
\rgroup	Delimiter
\arrowvert	Delimiter
\Arrowvert	Delimiter
\bracevert	Delimiter
\Vert	Delimiter
\vert	Delimiter
\uparrow	Delimiter
\downarrow	Delimiter
\updownarrow	Delimiter
\Uparrow	Delimiter
\Downarrow	Delimiter
\Updownarrow	Delimiter
\backslash	Delimiter
\rangle	Delimiter
\langle	Delimiter
\rbrace	Delimiter
\lbrace	Delimiter
\rceil	Delimiter
\lceil	Delimiter
\rfloor	Delimiter
\lfloor	Delimiter
\bigl	Delimiter
\bigm	Delimiter
\bigr	Delimiter
\Bigl	Delimiter
\Bigm	Delimiter
\Bigr	Delimiter
\biggl	Delimiter
\biggm	Delimiter
\biggr	Delimiter
\Biggl	Delimiter
\Biggm	Delimiter
\Biggr	Delimiter
\big#1	Delimiter
\Big#1	Delimiter
\bigg#1	Delimiter
\Bigg#1	Delimiter
\choose	Math
\brack	Math
\brace	Math
\sqrt	Math
\openup	Align
\mathpalette	Math
\root {} \of {}	Math
\vphantom	Math
\hphantom	Math
\phantom	Math
\mathstrut	Math
\smash	Math
\cong	MathRel(≌)
\notin	MathRel
\rightleftharpoons	MathRel
\over	MathRel
\doteq	MathRel
\log	MathOp
\lg	MathOp
\ln	MathOp
\lim	MathOp
\limsup	MathOp
\liminf	MathOp
\sin	MathOp
\arcsin	MathOp
\sinh	MathOp
\cos	MathOp
\arccos	MathOp
\cosh	MathOp
\tan	MathOp
\arctan	MathOp
\tanh	MathOp
\cot	MathOp
\coth	MathOp
\sec	MathOp
\csc	MathOp
\max	MathOp
\min	MathOp
\sup	MathOp
\inf	MathOp
\arg	MathOp
\ker	MathOp
\dim	MathOp
\hom	MathOp
\det	MathOp
\exp	MathOp
\Pr	MathOp
\gcd	MathOp
\deg	MathOp
\bmod	Math
\pmod	Math
\cases	Math
\matrix	Math
\pmatrix	Math
\bordermatrix	Math
\eqalign	Math
\displaylines	Math
\eqalignno	Math
\leqalignno	Math
\raggedbottom	Typeset
\normalbottom	Typeset
\folio	Debug
\nopagenumbers	Typeset
\advancepageno	Debug
\vfootnote{text}	Insertion
\footstrut	Debug
\endinsert	\*insert
\plainoutput	Debug
\pagebody	Debug
\makeheadline	Debug
\makefootline	Debug
\dosupereject	Debug
\pagecontents	Debug
\footnoterule	Debug
\magnification	Mag
\loggingall	Debug
\tracingall	Debug
\showhyphens	Debug
\fmtname	Debug(plain)
\fmtversion	Debug(3.1415..)
\obeylines	Typeset
