\addtocounter	Counters
\alph	Counters
\Alph	Counters
\arabic	Counters
\fnsymbol	Counters
\newcounter	Counters
\refstepcounter	Counters
\roman	Counters
\Roman	Counters
\stepcounter	Counters
\setcounter	Counters
\usecounter	Counters
\value	Counters
\label	References
\pageref	References
\ref	References
\newcommand	Definitions
\renewcommand	Definitions
\newenvironment	Definitions
\renewenvironment	Definitions
\newtheorem	Definitions
\newfont	Definitions
\documentclass	Documents
\documentclass{article}	Documents
\documentclass{report}	Documents
\documentclass{letter}	Documents
\documentclass{book}	Documents
\documentclass{slides}	Documents
\usepackage	Documents
\flushbottom	Documents
\onecolumn	Documents
\twocolumn	Documents
\raggedleft	env.flushright
\circle	env.picture
\dashbox	env.picture
\frame	env.picture
\framebox	env.picture
\line	env.picture
\linethickness	env.picture
\makebox	env.picture
\multiput	env.picture
\oval	env.picture
\put	env.picture
\shortstack	env.picture
\vector	env.picture
\cline	env.tabular
\hline	env.tabular
\multicolumn	env.tabular
\vline	env.tabular
\caption	env.floating
\bibitem	env.thebibliography
\cite	env.thebibliography
\nocite	env.thebibliography
\bibliographystyle	env.thebibliography
\bibliography	env.thebibliography
\verb	env.verbatim
\footnotemark	Footnotes
\footnotetext	Footnotes
\newlength	Lengths
\setlength	Lengths
\addtolength	Lengths
\settodepth	Lengths
\settoheight	Lengths
\settowidth	Lengths
\width	Lengths
\height	Lengths
\depth	Lengths
\totalheight	Lengths
\opening	Letters
\closing	Letters
\address	Letters
\signature	Letters
\location	Letters
\telephone	Letters
\cc	Letters
\encl	Letters
\ps	Letters
\makelabels	Letters
\\	Breaking
\\*	Breaking
\cleardoublepage	Breaking
\clearpage	Breaking
\enlargethispage	Breaking
\enlargethispage*	Breaking
\linebreak	Breaking
\newline	Breaking
\newpage	Breaking
\nolinebreak	Breaking
\nopagebreak	Breaking
\pagebreak	Breaking
\fussy	Breaking
\sloppy	Breaking
\maketitle	Pages
\author	Pages
\and	Pages
\date	Pages
\today	Pages
\thanks	Pages
\title	Pages
\pagenumbering{arabic}	Pages
\pagenumbering{roman}	Pages
\pagenumbering{Roman}	Pages
\pagenumbering{alph}	Pages
\pagenumbering{Alph}	Pages
\pagestyle{plain}	Pages
\pagestyle{empty}	Pages
\pagestyle{headings}	Pages
\pagestyle{myheadings}	Pages
\markboth	Pages
\markright	Pages
\thispagestyle{plain}	Pages
\thispagestyle{empty}	Pages
\thispagestyle{headings}	Pages
\thispagestyle{myheadings}	Pages
\part	Sectioning
\chapter	Sectioning
\section	Sectioning
\subsection	Sectioning
\subsubsection	Sectioning
\paragraph	Sectioning
\subparagraph	Sectioning
\part*	Sectioning
\chapter*	Sectioning
\section*	Sectioning
\subsection*	Sectioning
\subsubsection*	Sectioning
\paragraph*	Sectioning
\subparagraph*	Sectioning
\appendix	Sectioning
\addvspace	Boxes
\fbox	Boxes
\framebox	Boxes
\fboxrule	Boxes
\fboxsep	Boxes
\hspace	Boxes
\hspace*	Boxes
\makebox	Boxes
\mbox	Boxes
\newsavebox	Boxes
\parbox	Boxes
\raisebox	Boxes
\rule	Boxes
\sbox	Boxes
\savebox	Boxes
\usebox	Boxes
\vspace	Boxes
\vspace*	Boxes
\symbol	Chars
\include	Input
\includeonly	Input
\nofiles	Input
\tableofcontents	toc
\listoffigures	toc
\listoftables	toc
\addcontentsline	toc
\addtocontents	toc
\typeout	Interactive
\typein	Interactive
\textrm	Fonts
\rmfamily	Fonts
\textit	Fonts
\itshape	Fonts
\emph	Fonts
\textmd	Fonts
\mdseries	Fonts
\textbf	Fonts
\bfseries	Fonts
\textup	Fonts
\upshape	Fonts
\textsl	Fonts
\slshape	Fonts
\textsf	Fonts
\sffamily	Fonts
\textsc	Fonts
\scshape	Fonts
\texttt	Fonts
\ttfamily	Fonts
\textnormal	Fonts
\normalfont	Fonts
\mathrm	Fonts
\mathbf	Fonts
\mathsf	Fonts
\mathtt	Fonts
\mathit	Fonts
\mathnormal	Fonts
\mathcal	Fonts
\mathversion{bold}	Fonts
\mathversion{normal}	Fonts
\fontencoding	Fonts
\fontfamily	Fonts
\fontseries	Fonts
\fontshape	Fonts
\fontsize	Fonts
\selectfont	Fonts
\usefont    Fonts
\tiny	Size
\scriptsize	Size
\footnotesize	Size
\small	Size
\normalsize	Size
\large	Size
\Large	Size
\LARGE	Size
\huge	Size
\Huge 	Size
\(  Math
\)  Math
\[  Math
\]  Math
\frac	Math
\begin	Environment
\end	Environment
\'  env.tabbing
\<  env.tabbing
\=  env.tabbing
\>  env.tabbing
\`  env.tabbing
\a'  env.tabbing
\a=  env.tabbing
\a`  env.tabbing
\kill  env.tabbing
\pushtabs  env.tabbing
\lefteqn    env.eqnarray
\nonumber    env.eqnarray
