\badness	Box
\box	Box
\boxmaxdepth	Box
\cleaders	Box
\copy	Box
\dp	Box
\everyhbox	Box
\everyvbox	Box
\hbadness	Box
\hbox	Box
\hfuzz	Box
\hrule	Box
\ht	Box
\lastbox	Box
\leaders	Box
\overfullrule	Box
\prevdepth	Box
\setbox	Box
\unhbox	Box
\unhcopy	Box
\unvbox	Box
\unvcopy	Box
\vbadness	Box
\vbox	Box
\vfuzz	Box
\vrule	Box
\vtop	Box
\wd	Box
\xleaders	Box
\ 	Char
\accent	Char
\catcode	Char
\char	Char
\chardef	Char
\endlinechar	Char
\escapechar	Char
\lccode	Char
\lowercase	Char
\newlinechar	Char
\number	Char
\romannumeral	Char
\sfcode	Char
\string	Char
\uccode	Char
\uppercase	Char
\batchmode	Debug
\errhelp	Debug
\errmessage	Debug
\errorcontextlines	Debug
\errorstopmode	Debug
\meaning	Debug
\message	Debug
\nonstopmode	Debug
\pausing	Debug
\scrollmode	Debug
\show	Debug
\showbox	Debug
\showboxbreadth	Debug
\showboxdepth	Debug
\showlists	Debug
\showthe	Debug
\tracingcommands	Debug
\tracinglostchars	Debug
\tracingmacros	Debug
\tracingonline	Debug
\tracingoutput	Debug
\tracingpages	Debug
\tracingparagraphs	Debug
\tracingrestores	Debug
\tracingstats	Debug
\closein	File
\closeout	File
\endinput	File
\immediate	File
\input	File
\inputlineno	File
\openin	File
\openout	File
\output	File
\read	File
\shipout	File
\special	File
\write	File
\/	Font
\font	Font
\fontdimen	Font
\fontname	Font
\nullfont	Font
\hfil	Glue
\hfill	Glue
\hfilneg	Glue
\hskip	Glue
\hss	Glue
\lastskip	Glue
\unskip	Glue
\vfil	Glue
\vfill	Glue
\vfilneg	Glue
\vskip	Glue
\vss	Glue
\-	Hyphen
\defaulthyphenchar	Hyphen
\discretionary	Hyphen
\hyphenation	Hyphen
\hyphenchar	Hyphen
\language	Hyphen
\lefthyphenmin	Hyphen
\patterns	Hyphen
\righthyphenmin	Hyphen
\setlanguage	Hyphen
\uchyph	Hyphen
\holdinginserts	Insert
\insert	Insert
\insertpenalties	Insert
\splitbotmark	Insert
\splitfirstmark	Insert
\splitmaxdepth	Insert
\splittopskip	Insert
\vsplit	Insert
\day	Job
\deadcycles	Job
\dump	Job
\end	Job
\everyjob	Job
\jobname	Job
\mag	Job
\maxdeadcycles	Job
\month	Job
\time	Job
\year	Job
\kern	Kern
\lastkern	Kern
\lower	Kern
\moveleft	Kern
\moveright	Kern
\raise	Kern
\unkern	Kern
\else	Logic
\fi	Logic
\if	Logic
\ifcase	Logic
\ifcat	Logic
\ifdim	Logic
\ifeof	Logic
\iffalse	Logic
\ifhbox	Logic
\ifhmode	Logic
\ifinner	Logic
\ifmmode	Logic
\ifnum	Logic
\ifodd	Logic
\iftrue	Logic
\ifvbox	Logic
\ifvmode	Logic
\ifvoid	Logic
\ifx	Logic
\or	Logic
\afterassignment	Macro
\aftergroup	Macro
\begingroup	Macro
\csname	Macro
\def	Macro
\edef	Macro
\endcsname	Macro
\endgroup	Macro
\expandafter	Macro
\futurelet	Macro
\gdef	Macro
\global	Macro
\globaldefs	Macro
\let	Macro
\long	Macro
\noexpand	Macro
\outer	Macro
\relax	Macro
\the	Macro
\xdef	Macro
\botmark	Marks
\firstmark	Marks
\mark	Marks
\topmark	Marks
\above	Math
\abovedisplayshortskip	Math
\abovedisplayskip	Math
\abovewithdelims	Math
\atop	Math
\atopwithdelims	Math
\belowdisplayshortskip	Math
\belowdisplayskip	Math
\binoppenalty	Math
\defaultskewchar	Math
\delcode	Math
\delimiter	Math
\delimiterfactor	Math
\delimitershortfall	Math
\displayindent	Math
\displaylimits	Math
\displaystyle	Math
\displaywidowpenalty	Math
\displaywidth	Math
\eqno	Math
\everydisplay	Math
\everymath	Math
\fam	Math
\left	Math
\leqno	Math
\limits	Math
\mathaccent	Math
\mathbin	Math
\mathchar	Math
\mathchardef	Math
\mathchoice	Math
\mathclose	Math
\mathcode	Math
\mathinner	Math
\mathop	Math
\mathopen	Math
\mathord	Math
\mathpunct	Math
\mathrel	Math
\mathsurround	Math
\medmuskip	Math
\mkern	Math
\mskip	Math
\muskip	Math
\muskipdef	Math
\nolimits	Math
\nonscript	Math
\nulldelimiterspace	Math
\over	Math
\overline	Math
\overwithdelims	Math
\postdisplaypenalty	Math
\predisplaypenalty	Math
\predisplaysize	Math
\radical	Math
\relpenalty	Math
\right	Math
\scriptfont	Math
\scriptscriptfont	Math
\scriptscriptstyle	Math
\scriptspace	Math
\scriptstyle	Math
\skewchar	Math
\textfont	Math
\textstyle	Math
\thickmuskip	Math
\thinmuskip	Math
\underline	Math
\vcenter	Math
\hoffset	Page
\maxdepth	Page
\pagedepth	Page
\pagefilllstretch	Page
\pagefillstretch	Page
\pagefilstretch	Page
\pagegoal	Page
\pageshrink	Page
\pagestretch	Page
\pagetotal	Page
\topskip	Page
\voffset	Page
\vsize	Page
\adjdemerits	Paragraph
\baselineskip	Paragraph
\doublehyphendemerits	Paragraph
\emergencystretch	Paragraph
\everypar	Paragraph
\finalhyphendemerits	Paragraph
\hangafter	Paragraph
\hangindent	Paragraph
\hsize	Paragraph
\ignorespaces	Paragraph
\indent	Paragraph
\leftskip	Paragraph
\lineskip	Paragraph
\lineskiplimit	Paragraph
\looseness	Paragraph
\noboundary	Paragraph
\noindent	Paragraph
\par	Paragraph
\parfillskip	Paragraph
\parindent	Paragraph
\parshape	Paragraph
\parskip	Paragraph
\pretolerance	Paragraph
\prevgraf	Paragraph
\rightskip	Paragraph
\spacefactor	Paragraph
\spaceskip	Paragraph
\tolerance	Paragraph
\vadjust	Paragraph
\xspaceskip	Paragraph
\brokenpenalty	Penalty
\clubpenalty	Penalty
\exhyphenpenalty	Penalty
\floatingpenalty	Penalty
\hyphenpenalty	Penalty
\interlinepenalty	Penalty
\lastpenalty	Penalty
\linepenalty	Penalty
\outputpenalty	Penalty
\penalty	Penalty
\unpenalty	Penalty
\widowpenalty	Penalty
\advance	Register
\count	Register
\countdef	Register
\dimen	Register
\dimendef	Register
\divide	Register
\multiply	Register
\skip	Register
\skipdef	Register
\toks	Register
\toksdef	Register
\cr	Table
\crcr	Table
\everycr	Table
\halign	Table
\noalign	Table
\omit	Table
\span	Table
\tabskip	Table
\valign	Table
