\rm	Font
\sl	Font
\it	Font
\bf	Font
\tt	Font
\oldstyle	Font
\cal	Font
\magstep0	Magnification
\magstephalf	Magnification
\magstep1	Magnification
\magstep2	Magnification
\magstep3	Magnification
\magstep4	Magnification
\magstep5	Magnification
\magstep6	Magnification
\'	Accent
\'	Accent
\^	Accent
\"	Accent
\~	Accent
\=	Accent
\.	Accent
\v	Accent
\u	Accent
\H	Accent
\t	Accent
\c	Accent
\d	Accent
\b	Accent
\oe	Char
\OE	Char
\ae	Char
\AE	Char
\aa	Char
\AA	Char
\o	Char
\O	Char
\l	Char
\L	Char
\ss	Char
\dag	Char
\ddag	Char
\S	Char
\P	Char
\copyright	Special
\headline={stuff}	Insertion
\footline={stuff}	Insertion
\raggedbottom	Insertion
\folio	Insertion
\nopagenumbers	Insertion
\footnote{mark}{text}	Insertion
\topinsert{stuff}\endinsert	Insertion
\midinsert{stuff}\endinsert	Insertion
\pageinsert{stuff}\endinsert	Insertion
\alpha	MathChar
\beta	MathChar
\gamma	MathChar
\delta	MathChar
\epsilon	MathChar
\zeta	MathChar
\eta	MathChar
\theta	MathChar
\iota	MathChar
\kappa	MathChar
\lambda	MathChar
\mu	MathChar
\nu	MathChar
\xi	MathChar
\pi	MathChar
\rho	MathChar
\sigma	MathChar
\tau	MathChar
\upsilon	MathChar
\phi	MathChar
\chi	MathChar
\psi	MathChar
\omega	MathChar
\varepsilon	MathChar
\vartheta	MathChar
\varpi	MathChar
\varrho	MathChar
\varsigma	MathChar
\varphi	MathChar
\Gamma	MathChar
\Delta	MathChar
\Theta	MathChar
\Lambda	MathChar
\Xi	MathChar
\Pi	MathChar
\Sigma	MathChar
\Upsilon	MathChar
\Phi	MathChar
\Psi	MathChar
\Omega	MathChar
\aleph	MathChar
\hbar	MathChar
\imath	MathChar
\jmath	MathChar
\ell	MathChar
\wp	MathChar
\Re	MathChar
\Im	MathChar
\partial	MathChar
\infty	MathChar
\prime	MathChar
\emptyset	MathChar
\nabla	MathChar
\surd	MathChar
\top	MathChar
\bot	MathChar
\angle	MathChar
\forall	MathChar
\exists	MathChar
\neg	MathChar
\flat	MathChar
\natural	MathChar
\sharp	MathChar
\clubsuit	MathChar
\diamondsuit	MathChar
\heartsuit	MathChar
\spadesuit	MathChar
\coprod	MathChar
\bigvee	MathChar
\bigwedge	MathChar
\biguplus	MathChar
\bigcap	MathChar
\bigcup	MathChar
\intop	MathChar
\prod	MathChar
\sum	MathChar
\bigotimes	MathChar
\bigoplus	MathChar
\bigodot	MathChar
\ointop	MathChar
\bigsqcup	MathChar
\smallint	MathChar
\triangleleft	MathChar
\triangleright	MathChar
\bigtriangleup	MathChar
\bigtriangledown	MathChar
\wedge	MathChar
\vee	MathChar
\cap	MathChar
\cup	MathChar
\ddagger	MathChar
\dagger	MathChar
\sqcap	MathChar
\sqcup	MathChar
\uplus	MathChar
\amalg	MathChar
\diamond	MathChar
\bullet	MathChar
\wr	MathChar
\div	MathChar
\odot	MathChar
\oslash	MathChar
\otimes	MathChar
\ominus	MathChar
\oplus	MathChar
\mp	MathChar
\pm	MathChar
\circ	MathChar
\bigcirc	MathChar
\setminus	MathChar
\cdot	MathChar
\ast	MathChar
\times	MathChar
\star	MathChar
\propto	MathChar
\sqsubseteq	MathChar
\sqsupseteq	MathChar
\parallel	MathChar
\mid	MathChar
\dashv	MathChar
\vdash	MathChar
\nearrow	MathChar
\searrow	MathChar
\nwarrow	MathChar
\swarrow	MathChar
\Leftrightarrow	MathChar
\Leftarrow	MathChar
\Rightarrow	MathChar
\neq	MathChar
\leq	MathChar
\geq	MathChar
\succ	MathChar
\prec	MathChar
\approx	MathChar
\succeq	MathChar
\preceq	MathChar
\supset	MathChar
\subset	MathChar
\supseteq	MathChar
\subseteq	MathChar
\in	MathChar
\ni	MathChar
\gg	MathChar
\ll	MathChar
\not	MathChar
\leftrightarrow	MathChar
\leftarrow	MathChar
\rightarrow	MathChar
\mapstochar	MathChar
\sim	MathChar
\simeq	MathChar
\perp	MathChar
\equiv	MathChar
\asymp	MathChar
\smile	MathChar
\frown	MathChar
\leftharpoonup	MathChar
\leftharpoondown	MathChar
\rightharpoonup	MathChar
\rightharpoondown	MathChar
\joinrel	MathChar
\relbar	MathChar
\Relbar	MathChar
\lhook	MathChar
\rhook	MathChar
\bowtie	MathChar
\models	MathChar
\Longrightarrow	MathChar
\longrightarrow	MathChar
\longleftarrow	MathChar
\Longleftarrow	MathChar
\longmapsto	MathChar
\longleftrightarrow	MathChar
\Longleftrightarrow	MathChar
\iff	MathChar
\ldotp	MathChar
\cdotp	MathChar
\colon	MathChar
\ldots	MathChar
\cdots	MathChar
\vdots	MathChar
\ddots	MathChar
\maxdimen	Parameter
\hideskip	Parameter
\centering	Parameter
\smallskipamount	Parameter
\medskipamount	Parameter
\bigskipamount	Parameter
\normalbaselineskip	Parameter
\normallineskip	Parameter
\normallineskiplimit	Parameter
\jot	Parameter
\interdisplaylinepenalty	Parameter
\interfootnotelinepenalty	Parameter
